45 25
wwwwwwwwwwwwwwwwwwwwwwwwwwwwwwwwwwwwwwwwwwwww
w                wwwwwww                   ww
w                wwwwwww                   ww
w                wwwwwww                   ww
w                wwwwwww                   ww                     
w      w         wwwwwww       w           ww
w      w         wwwwwww       w           ww
w      w               w       wwwwww      ww 
w      w               w g     w           ww
w      w            g  w       w           ww
w      wwwwwwwww       w       w       wwwwww
w              w       w       w           ww                         
w              w       w       w g         ww                          
wwww           w       w       w           ww                       
w              w       w       w           ww                        
w       wwwwwwww       w       wwwwww      ww         
w              w       w       w           ww                             
w              w       w       w           ww                             
w              w       w       w           ww                    
wwwwwwwww      w       w       w   g   wwwwww
w         g    w               w           ww     
w              w               w           ww
w              w               w           ww
w              w               w           ww
wwwwwwwwwwwwwwwwwwwwwwwwwwwwwwwwfffffffffffww